#############
....####...##
#.#.#.#.#.#.#
...##....###
...##@##...##
########....#
............#
########..###
.............
#############