............####
##..##.
..#.#####.####
.......#####...#
......@..###...#
....####........
.......######...
####....#####..#
##........##....
................